#separator:tab
#html:true
"Theo Hồ Chí Minh,ưu điểm lớn nhất của chủ nghĩa Mác là gì?<br>A. Bản chất cách mạng<br>B. Chủ nghĩa nhân đạo triệt để<br>C. Phương pháp làm việc biện chứng<br>D. Bản chất khoa học<br>"	B
"Việt Nam Độc Lập Đồng minh được thành lập vào thời gian nào?<br>A. 19/5/1941<br>B. 19/5/1930<br>C. 26/3/1941<br>D. 3/9/1945<br>"	A
"Điểm giống nhau trong tư tưởng về xây dựng nhà nước của Hồ Chí Minh và các bậc<br>tiền nhân trong quá khứ là:<br>A. Dựa vào bạo lực vũ trang<br>B. Dựa vào dân<br>C. Dựa vào tài năng, trí tuệ, óc phán đoán<br>D. Dựa vào đạo đức cách mạng<br>"	D
"Hồ Chí Minh cho rằng:<br>A. Đạo đức nhân văn xã hội chủ nghĩa là sức cuốn hút của chủ nghĩa cộng sản<br>B. Đạo đức nhân văn xã hội chủ nghĩa là sức cuốn hút của chủ nghĩa xã hội<br>C. Đạo đức nhân văn xã hội chủ nghĩa là sức cuốn hút của chủ nghĩa dân chủ<br>"	B
"Một trong những truyền thống tốt đẹp của tư tưởng và văn hoá Việt Nam được Hồ<br>Chí Minh tiếp thu để hình thành tư tưởng của mình là:<br>a. Chủ nghĩa yêu nước Việt Nam.<br>b. Những mặt tích cực của Nho Giáo<br>c. Tư tưởng vị tha của Phật giáo<br>d. Tư tưởng bác ái của Thiên Chúa Giáo.<br>"	A
"Hồ Chí Minh dạy học ở trường Dục Thanh, Phan Thiết trong khoảng thời gian nào?<br>A. Năm 1909 - 1910<br>B. Năm 1909 - 1911<br>C. Năm 1908 - 1909<br>D. Năm 1910 - 1911<br>"	D
"Ngoại ngữ nào sau đây được Hồ Chí Minh sử dụng trong thời gian học tập ở trường<br>Quốc học Huế?<br>a. Tiếng Anh<br>b. Tiếng Pháp<br>c. Tiếng Trung<br>"	B
"Hồ chí minh cho rằng cách mạng giải phóng dân tộc cần tiến hành<br>a. chủ động, sáng tạo và có khả năng giành thắng lợi trước cách mạng vô sản ở<br>chính quốc<br>b. chủ động, sáng tạo và có khả năng giành thắng lợi trước cách mạng vô sản thế<br>giới<br>c. chủ động, sáng tạo và có khả năng giành thắng lợi trước cách mạng thuộc địa<br>"	A
"Hồ chí minh cho rằng giải phóng dân tộc phải gắn liền với<br>a. độc lập, tự do và hạnh phúc<br>b. dân quyền và tự do<br>c. nhân sinh và hạnh phúc<br>"	A
"Đại đoàn kết dân tộc được xác định là nhiệm vụ nào trong những nhiệm vụ dưới đây<br>của Đảng và của toàn dân tộc ta?<br>a. Cơ bản của Đảng và của dân tộc<br>b. Hàng đầu của Đảng và của dân tộc<br>c. Quan trọng của Đảng và của dân tộc ta<br>d. Thiết yếu<br>"	B
"Hồ chí minh nhấn mạnh<br>a. đại đoàn kết dân tộc thể hiện trong đường lối, chủ trương, chính sách, mọi lĩnh vực<br>hoạt động của đảng.<br>b. đoàn kết dân tộc thể hiện trong đường lối, chủ trương, chính sách, mọi lĩnh vực<br>hoạt động của đảng.<br>c. đại đoàn kết toàn dân thể hiện trong đường lối, chủ trương, chính sách, mọi lĩnh<br>vực hoạt động của đảng.<br>"	A
"Theo Hồ Chí Minh, để thực hành đoàn kết rộng rãi, cần có niềm tin vào (....).<br>a. Dân<br>b. Đảng<br>c. Chính quyền<br>"	A
"Theo Hồ Chí Minh, đạo đức là nhân tố tạo nên:<br>a. sức mạnh, sức hấp dẫn của chủ nghĩa xã hội.<br>b. sức mạnh, sức hấp dẫn của chủ nghĩa Mác-Lênin.<br>c. sức mạnh, sức hấp dẫn của tư tưởng Hồ Chí Minh.<br>"	A
"Hồ Chí Minh vạch ra nhiệm vụ hàng đầu của cách mạng ở thuộc địa là:<br>a. Giải phóng dân tộc<br>b. Giải phóng giai cấp<br>c. Giải phóng nhân loại<br>"	A
"Hồ chí minh lưu ý xây dựng đội ngũ cán bộ nhà nước<br>a. vừa sản xuất, vừa chiến đấu<br>b. dũng cảm, khiêm tốn<br>c. vừa hồng vừa chuyên<br>"	A
"Hồ chí minh cho rằng, nhà nước của dân, do dân và vì dân phải<br>a. là nhà nước hợp hiến<br>b. là nhà nước dân chủ<br>c. là nhà nước dân quyền<br>...<br>Luận điểm "Công cuộc giải phóng anh em chỉ có thể thực hiện bằng sự nỗ lực của<br>bản thân anh em" là của:<br>a. C. Mác<br>b. Ph. Ăngghen<br>c. V.I.Lênin<br>d. Hồ Chí Minh<br>"	D
"Theo Hồ Chí Minh, văn hóa là đời sống tinh thần của xã hội, thuộc:<br>a. Kiến trúc thượng tầng<br>b. Cơ sở hạ tầng<br>c. Tất cả các phương án<br>d. Tất cả các phương án<br>"	A
"Nội dung lớn trong nguyên tác xây dựng cáo mới quan hệ quốc tế đó của Hồ Chí<br>Minh đó là:<br>Xây dựng mối quan hệ hòa bình, hữu nghị, hợp tác với nhân dân lao động các nước trên thế<br>giới<br>Luật cải cách ruộng đất quy định nội dung nào?<br>A. Nghiêm cấm việc bắt giữ và giết hại trái phép, nghiêm cấm đánh đập, tra tấn hoặc<br>dùng mọi thứ nhục hình khác.<br>B. Nghiêm cấm việc bắt giữ và giết hại nhân dân, nghiêm cấm đánh đập, tra tấn hoặc<br>dùng mọi thứ nhục hình khác.<br>C. Phân chia ruộng đất cho dân cày, dân nghèo, không can thiệp vào sản xuất<br>D. Tát cả các phương án trên<br>"	A
"Đâu là sự sáng tạo của Hồ Chí Minh vẽ Chủ nghĩa xã hội ở Việt Nam?<br>A. Sáng tạo trong cách thức đi lên xây dựng chủ nghĩa xã hội<br>B. Phương pháp bạo lực cách mạng<br>C. Lựa chọn con đường đi lên xây dựng chủ nghĩa xã hội<br>D. Phân tích đúng tình hình nước ta<br>"	C
"Hồ chí minh lưu ý đảng về vấn đề đại đoàn kết dân tộc thông qua luận điểm<br>a. đoàn kết không chỉ nằm ở chủ trương, đường lối, chính sách mà phải biến thành<br>sức mạnh<br>b. đoàn kết không chỉ nằm ở chủ trương, đường lối, chính sách mà phải biến thành tư<br>tưởng<br>c. đoàn kết không chỉ nằm ở chủ trương, đường lối, chính sách mà phải biến thành<br>đường lối<br>"	A
"Theo Hồ Chí Minh, Liêm là luôn tôn trọng của công và của dân. Phải:<br>a. "trong sạch, không tham lam" tiền của, địa vị, danh tiếng.<br>b. "trong sáng, không tham lam" tiền của, địa vị, danh tiếng.<br>c. "trong sạch, không ham muốn" tiền của, địa vị, danh tiếng.<br>d. "trong sạch, không đòi hỏi" tiền của, địa vị, danh tiếng.<br>"	A
"Nội dung nào không đúng với bản chất giai cấp công nhân của nhà nước theo tư<br>tưởng Hồ Chí Minh?<br>a. Nhà nước do Đảng Cộng sản lãnh đạo.<br>b. Tính định hướng xã hội chủ nghĩa của sự phát triển đất nước.<br>c. Nguyên tắc tổ chức và hoạt động cơ bản của nó là nguyên tắc tập trung dân chủ.<br>d. Nhà nước dưới sự lãnh đạo của Quốc hội.<br>"	D
"Hồ Chí Minh vạch ra mục tiêu của cách mạng giải phóng dân tộc thuộc địa là:<br>a. Đánh đổ ách thống trị của chủ nghĩa thực dân, giành độc lập dân tộc và thiết lập<br>chính quyền của nhân dân.<br>b. Đánh đổ ách thống trị của chủ nghĩa thực dân, giành độc lập dân tộc và thiết lập<br>chính quyền về tay người lao động.<br>c. Đánh đổ ách thống trị của chủ nghĩa thực dân, giành độc lập dân tộc và thiết lập<br>chính quyền về tay lực lượng cách mạng.<br>d. Đánh đổ ách thống trị của chủ nghĩa thực dân, giành độc lập dân tộc và thiết lập<br>chính quyền của công nông.<br>"	A
"Hồ chí minh vạch ra lực lượng cách mạng giải phóng dân tộc<br>a. cách mạng là sự nghiệp của quần chúng bị áp bức<br>b. cách mạng là sự nghiệp của công nông<br>c. cách mạng là sự nghiệp của mọi người dân<br>"	A
"Hồ Chí Minh quân tâm mối quan hệ với Trung Quôc trên tinh thần:<br>A. "Vừa là đông chí, vừa là đông đội"<br>B. "Vừa là đồng đội, vừa là đồng chi"<br>C. "Vừa là đồng chí, vừa là anh em".<br>"	C
"Khi nói về hồ chí minh, báo uruquay viết<br>a. ông có một trái tim bao la như vũ trụ và tình yêu trẻ thơ vô bờ bến<br>b. ông người có tình cảm bao la như vũ trụ và tình yêu trẻ thơ vô bờ bến<br>c. ông là một trái như vũ trụ và tình yêu trẻ thơ vô bờ bến<br>"	A
"Để có thể tận dụng thời cơ vượt qua thách thức, trên cơ sở nhận thức và Vận dụng<br>sáng tạo Hồ chí Minh, cần tập trung vào vấn đề nào?<br>A. Kiên định cách mạng<br>B. Kiên định phương pháp cách mang<br>C. Kiên định theo chủ nghĩa Mác -Lênin và tư tưởng Hồ Chí Minh<br>D. kiên định con đường xây dựng đất nước<br>"	C
"Nguyễn Ái Quốc vào Đảng Xã hội Pháp năm nào?<br>a. 1917<br>b. 1918<br>c. 1919<br>d. 1920<br>"	C
"Hồ chí minh cho rằng:<br>a. chủ nghĩa dân tộc là động lực lớn của đất nước.<br>b. chủ nghĩa dân tộc là khát khao lớn của đất nước.<br>c. chủ nghĩa dân tộc là mục tiêu lớn của đất nước.<br>d. chủ nghĩa dân tộc là chiến lược hàng đầu của cách mạng.<br>"	A
"Theo Hồ Chí Minh, để kiểm soát quyền lực nhà nước trước tiên cần phải làm gì?<br>A. Phát huy vai trò giám sát của dân chúng<br>B. Phát huy vai trò, trách nhiệm của Đảng Cộng sản<br>C. Tăng cường vai trò giám sát của hội đồng nhân dân<br>D. Tăng cường trách nhiệm của mặt trận tổ quốc<br>"	B
"Hồ chí minh cho rằng<br>a. vấn đề dân tộc và vấn đề giai cấp là quan hệ chính trị<br>b. vấn đề dân tộc và vấn đề giai cấp là quan hệ kinh tế<br>c. vấn đề dân tộc và vấn đề giai cấp là quan hệ thể hiện trong mọi mặt của xã hội<br>"	C
"Đâu là nguyên tắc xây dựng đạo đức mới trong tư tưởng hồ chí minh<br>a. phải tu dưỡng đạo đức suốt đời<br>b. phải tu dưỡng đạo đức thường xuyên<br>c. phải tu dưỡng đạo đức hàng ngày<br>"	A
"Theo hồ chí minh, ngoài lợi ích của giai cấp, của nhân dân và toàn thể dân tộc việt<br>nam, đảng:<br>a. không còn lợi ích nào khác<br>b. còn vì lợi ích của mình<br>c. còn vì lợi ích của nhà nước<br>"	A
"Theo Hồ Chí Minh, đánh giá cán bộ phải:<br>A. Tiến hành thường xuyên<br>B. Khách quan, trung thực<br>C. Phải tự biết mình, biết người<br>D. Phải đủ trong sạch<br>"	B
"Trong di chúc hồ chí minh viết rằng<br>a. Đảng phải có kế hoạch tốt để phát triển kinh tế, văn hóa<br>b. Đảng phải có kế hoạch tốt để phát triển kinh tế, chính trị<br>c. Đảng phải có kế hoạch tốt để phát triển kinh tế, xã hội<br>"	A
"Hồ chí minh luôn nhấn mạnh thái độ nào sau đây của đảng viên:<br>a. nêu gương<br>b. dũng cảm<br>c. đoàn kết<br>d. chí công vô tư<br>"	A
"Hồ chí minh cho rằng đạo đức cách mạng không phải:<br>a. trên trời sa xuống<br>b. phẩm chất vốn có<br>c. tự nhiên mà có<br>"	A
"Theo Hồ Chí Minh " Tất cả...trong nước là của toàn thể nhân dân Việt Nam"<br>A. Quyền bính<br>B. Quyền binh<br>C. Quyền lực<br>D. Quyền hành<br>"	A
"Hồ chí minh cho rằng giải phóng dân tộc là nhiệm vụ của cách mạng nào sau đây<br>a. Cách mạng nhân sinh tự do<br>b.Cách mạng dân chủ tư sản<br>c. Cách mạng XHCN<br>"	C
"Khi nói về mặt trận, hồ chí minh cho rằng<br>a. mặt trận phải được xây dựng trên nền tảng khối liên minh công - nông - trí thức, đặt<br>dưới sự lãnh đạo của đảng<br>b. mặt trận phải được xây dựng trên nền tảng khối liên minh công - nông - trí thức, đặt<br>dưới sự lãnh đạo của mặt trân phản đế<br>c. mặt trận phải được xây dựng trên nền tảng khối liên minh công - nông - trí thức, đặt<br>dưới sự lãnh đạo của giai cấp công nhân<br>"	A
"Hồ chí minh nhắc cán bộ nhà nước phải biết<br>a. học tập từ nhân dân<br>b. tự tôn dân tộc trước nhân dân<br>c. dũng cảm trước nhân dân<br>"	A
"Hồ chí minh lưu ý trong công tác xây dựng mặt trận như sau<br>a. khối đoàn kết trong mặt trận phải xuất phát từ mục tiêu chung<br>b. khối đoàn kết trong mặt trận phải xuất phát từ mục tiêu cụ thể<br>c. khối đoàn kết trong mặt trận phải xuất phát từ mục tiêu cơ bản<br>"	A
"Theo hồ chí minh, cách mạng giải phóng dân tộc muốn thắng lợi phải do ai lãnh đạo?<br>a. đảng cộng sản.<br>b. giai cấp công nhân.<br>c.giai cấp vô sản<br>d. đảng của giai cấp tư sản<br>"	A
"Hồ chí minh cho rằng, nhà nước của dân, do dân và vì dân phải<br>a. do đảng lãnh đạo và nhân dân làm chủ<br>b. do nhân dân quản lý và nhân dân làm chủ<br>c. do giai cấp công nhân lãnh đạo và nhân dân làm chủ<br>"	A
"Theo hồ chí minh, nội dung nào không đúng để phát huy động lực con người:<br>a. phát huy sức mạnh đoàn kết của cả cộng đồng dân tộc.<br>b. phát huy sức mạnh của cá nhân con người.<br>c. phát huy các yếu tố chính trị, tinh thần.<br>"	B
"Theo hồ chí minh, nhà nước do dân thể hiện ở chỗ<br>a. do nhân dân quyết đinh<br>b. do nhân dân chi phối<br>c. do nhân dân áp đặt<br>d. Do nhân dân kiểm soát<br>"	A
"Theo hồ chí minh, ưu điểm lớn nhất của chủ nghĩa mác là gì?<br>a. bản chất cách mạng<br>b. chủ nghĩa nhân đạo triệt để<br>c. phương pháp làm việc biện chứng<br>d. bản chất khoa học<br>"	C
"Hồ chí minh cho rằng công tác cán bộ cần chú ý<br>a. hiểu và đánh giá đúng đảng viên<br>b. hiểu và đánh giá đúng cán bộ<br>c. hiểu và đánh giá đúng quần chúng<br>"	B
"Chọn phương án trả lời đúng với một trong những giai đoạn hình thành và phát triển<br>tư tưởng hồ chí minh?<br>a. từ năm 1890 - 1911: thời kỳ nghiên cứu, khảo sát thực tế, đến với chủ nghĩa mác -<br>lênin.<br>b. từ năm 1921 - 1930: thời kỳ hình thành cơ bản tư tưởng về con đường cách mạng<br>việt nam.<br>c. từ năm 1911 - 1920: thời kỳ hình thành tư tưởng yêu nước, chí hướng cứu nước<br>"	B
"Đâu là chuẩn mực đạo đức cách mạng trong tư tưởng hồ chí minh<br>a. có tinh thần quốc tế trong sáng<br>b. có tinh thần quốc tế cao đẹp<br>c. có tinh thần quốc tế chân chính<br>"	A
"Tư tưởng hồ chí minh được hình thành và phát triển qua mấy giai đoạn?<br>a. 3<br>b. 4<br>c. 5<br>d. 6<br>"	C
"Hồ chí minh cho rằng<br>a. độc lập dân tộc gắn liền với chủ nghĩa xã hội.<br>b. giải phóng dân tộc gắn liền với chủ nghĩa xã hội.<br>c. giải phóng dân tộc gắn với chủ nghĩa dân tộc<br>"	A
"Hồ chính minh cho rằng<br>a. còn non, còn nước, còn người<br>b. còn non, còn nước, còn tự do<br>c. còn non, còn nước, còn chủ nghĩa xã hội<br>"	A
"Theo hồ chí minh, tính khoa học của nền văn hoá mới thể hiện ở tính hiện đại, tiên<br>tiến, thuận với:<br>a. trào lưu tiến hoá của dân tộc.<br>b. trào lưu tiến hoá của thời đại.<br>c. trào lưu tiến hoá của khoa học kỹ thuật.<br>"	B
"Tư tưởng, văn hóa phương Tây lấy<br>A. Cảm tính và khoa học làm tiêu chuẩn<br>B. Lý tính và khoa học là tiêu chuẩn<br>C. Tư duy và sự phản biện làm tiêu chuẩn<br>D. Sự phản biện và lý tỉnh làm tiêu chuẩn<br>"	B
"Đâu không phải là điểm giống nhau giữa chủ nghĩa xã hội và chủ nghĩa cộng sản<br>theo Hồ Chí Minh ?<br>A. Sức sản xuất phát triển cao<br>B. Tư liệu sản xuất là của chung<br>C. Không còn giai cấp áp bức bóc lột<br>D. Năng suất lao động phát triển<br>"	D
"Giai đoạn nào sau đây hình thành cơ bản tư tưởng hồ chí minh<br>a. 1925 đến 1930<br>b. 1930 đến 1945<br>c. 1921 đến 1930<br>"	C
"Theo hồ chí minh, về bước đi trong thời kỳ quá độ, chúng ta phải:<br>a. theo bước đi của các nước xã hội chủ nghĩa.<br>b. căn cứ vào đặc điểm lịch sử cụ thể của nước ta từ đó có bước đi phù hợp.<br>c. căn cứ vào đặc điểm lịch sử cụ thể của nước ta từ đó có bước đi phù hợp, đi bước<br>nào vững chắc bước ấy.<br>d. bước đi chậm, mạnh, vững chắc.<br>"	C
"Một trong những nguyên tắc xây dựng đảng của hồ chí minh là:<br>a. tập thể lãnh đạo, quần chúng phụ trách.<br>b. tập thể lãnh đạo, cá nhân phụ trách.<br>c. tập thể lãnh đạo, đảng viên phụ trách.<br>d. cá nhân lãnh đạo, tập thể phụ trách.<br>"	B
""Công nông là gốc của cách mạng, còn học trò, nhà buôn nhỏ, điền chủ nhỏ là ...cách<br>mạng của công nông"<br>A. Bạn bè<br>B. Bầu bạn<br>C. Đồng minh<br>D. Liên minh<br>"	B
"Theo hồ chí minh, vấn đề cốt lõi của cách mạng giải phóng dân tộc thuộc địa là<br>a. vấn đề tự do dân chủ<br>b. vấn đề độc lập dân tộc<br>c. vấn đề ruộng đất<br>"	B
"Quy luật ra đời của đảng theo quan điểm của hồ chí minh đã làm thay đổi cơ bản<br>a. về bản chất của đảng cộng sản việt nam<br>b. về nội dung của đảng cộng sản việt nam<br>c. về kết cấu của đảng cộng sản việt nam<br>"	A
"Hồ chí minh nhận định<br>a. đại đoàn kết toàn dân là sức mạnh, là nguồn gốc của mọi thắng lợi<br>b. đại đoàn kết dân tộc là sức mạnh, là nguồn gốc của cnxh<br>c. đoàn kết dân tộc là sức mạnh, là nguồn gốc của cách mạng<br>"	A
"Theo hồ chí minh, dân là chủ nghĩa là:<br>a. đề cập tới vị trí của dân.<br>b. đề cập tới vị thế của dân.<br>c. đề cập tới trách nhiệm của dân.<br>d. đề cập tới năng lực của dân<br>"	B
"Đâu là nguyên tắc xây dựng đạo đức mới trong tư tưởng hồ chí minh<br>a. phải tu dưỡng đạo đức suốt đời<br>b. phải tu dưỡng đạo đức thường xuyên<br>c. phải tu dưỡng đạo đức hằng ngày<br>"	A
"Theo Hồ Chí Minh, dân chủ là tư tưởng phải được tự do. Tự do là đối Với mọi vấn đề,<br>mọi người tự do bày tỏ ý kiến của mình, góp phần tìm ra:<br>A. Chân lý<br>B. Thực tiễn.<br>C. Lý lẽ.<br>D. Nguyên tắc.<br>"	A
"Hồ chí minh nhấn mạnh vấn đề nào sau đây trong lối sống của cán bộ nhà nước<br>a. tiết kiệm<br>b. tự tôn<br>c. lao động<br>"	B
"Đối Với Hồ Chí Minh, phải biết "dễ (1...) lần không dân cũng chịu, khổ (2...) lần dân<br>liệu cũng xong".<br>A. 1.vạn 2.trăm<br>B. 1.trăm 2.vạn<br>C. 1.nghìn 2.triệu<br>D. 1.triệu 2.nghìn<br>"	B
"Quan điểm nào dưới đây phản ánh phương thức tiếp cận về cnxh của hồ chí minh<br>a. hồ chí minh tiếp cận cnxh từ chủ nghĩa yêu nước và truyền thống văn hoá tốt đẹp<br>của dân tộc<br>b. hồ chí minh tiếp cận cnxh từ chủ nghĩa yêu nước và truyền thống văn hoá tốt đẹp<br>của nhân loại<br>c. hồ chí minh tiếp cận cnxh từ chủ nghĩa yêu nước và truyền thống văn hoá tốt đẹp<br>của chủ nghĩa mác-lênin.<br>"	A
"Đâu là sai lầm trong cải cách ruộng đất của ta trong thời kỳ cải cách ruộng đất?<br>A- Đánh giá sai lầm Về tình hình khác biệt giữa nông thôn Liên Xô và Việt Nam, quá<br>tin tưởng và chịu sức ép của các cô vấn Liên Xô<br>B. Đánh giá sai lầm Về tình hình khác biệt giữa nông thôn, thành thị Trung Quốc và<br>Việt Nam, quá tin tưởng và chịu sức ép của các cố vấn của Trung Quốc<br>C. Đánh giá sai lầm Về tình hình khác biệt giữa nông thôn Trung Quốc và Việt Nam,<br>quá tin tưởng và chịu sức ép của các cố vấn Trung Quốc<br>D. Tất cả các phương án trên<br>"	C
"Hồ Chí Minh cho rằng: "Một dân tộc, một đảng và mỗi con người, ngày hôm qua là vĩ<br>đại, có sức hấp dẫn lớn, không nhất định hôm nay và ngày mai vẫn được mọi người<br>yêu mến và ca ngợi, nếu lòng da không trong sáng nữa, nếu...<br>A. Sa vào tham ô, lãnh phí<br>B. Sa vào chủ nghĩa cá nhân.<br>C. Thoái hóa biến chất.<br>"	B
"Tìm đáp án sai<br>Khái niệm tư tưởng Hồ Chí Minh mà Đại hội IX (2001) nêu lên bao gồm:<br>a. Bản chất cách mạng và khoa học của tư tưởng Hồ Chí Minh<br>b. Nguồn gốc tư tưởng, lý luận của tư tưởng Hồ Chí Minh<br>c. Nội dung tư tưởng Hồ Chí Minh<br>d. Kết cấu tư tưởng Hồ Chí Minh<br>"	D
"Đâu là quan điểm của hồ chí minh về xây dựng con người?<br>a. con người cụ thể, lịch sử<br>b. con người cụ thể, văn hóa<br>c. con người cụ thể, xã hội<br>d. con người lịch sử, văn hóa<br>"	A
"Trong hơn 30 năm ớ nước ngoài, Hồ Chí Minh đã chịu ảnh hưởng sâu rộng của nền<br>văn hóa nào?<br>A. Văn hóa dân chủ<br>B. Văn hóa tự do<br>C. Văn hóa vô sản<br>D. Văn hóa bình đẳng<br>"	A
"Hồ chí minh vạch ra mâu thuẫn cơ bản của cách mạng dân tộc thuộc địa là<br>a. nhân dân với thực dân, phong kiến<br>b. nhân dân với thực dân, địa chủ<br>c. nhân dân với thực dân, đế quốc<br>"	A
"Câu thơ "1945 — Việt Nam độc lập" được Bác viết trong tác phẩm nào?<br>A. Nhật ký trong tù<br>B. Lịch sử nước ta<br>C. Tóm tắt lịch sử nước ta<br>D. Diễn ca lịch sử Việt Nam<br>"	B
"Theo hồ chí minh, mọi người phải hiểu và tuyệt đối chấp hành pháp luật, bất kể người<br>đó giữ cương vị nào. vì thần linh pháp quyền là:<br>a. sức mạnh do thần linh và vì con người.<br>b. sức mạnh do con người và vì con người.<br>c. sức mạnh do con người và vì thần linh.<br>"	B
"Khẩu hiệu chiến lược: "giai cấp vô sản tất cả các nước và các dân tộc bị áp bức,<br>đoàn kết lại" là của:<br>a. c. mác<br>b. ph. ăngghen<br>c. v.i.lênin<br>d. hồ chí minh<br>"	C
"Tìm ra luận điểm sai trong tư tưởng hồ chí minh khi người lưu ý tiếp nhận và vận<br>dụng chủ nghĩa mác - lênin:<br>a. một là, việc học tập, nghiên cứu, tuyên truyền chủ nghĩa mác - lênin phải luôn phù<br>hợp với từng đối tượng.<br>b. hai là, việc vận dụng chủ nghĩa mác - lênin phải luôn luôn kiên định trong mọi hoàn<br>cảnh.<br>c. ba là, trong quá trình hoạt động, đảng ta phải chú ý học tập, kế thừa những kinh<br>nghiệm tốt của các đảng cộng sản khác, đồng thời đảng ta phải tổng kết kinh nghiệm<br>của mình để bổ sung chủ nghĩa mác - lênin.<br>d. bốn là, đảng ta phải tăng cường đấu tranh để bảo vệ sự trong sáng của chủ nghĩa<br>mác - lênin.<br>"	B
"Đối tượng chủ yếu của tư tưởng hồ chí minh là<br>A. Cách mạng xã hội chủ nghĩa<br>B. Cách mạng Việt Nam<br>C. Cách mạng Đông Dương<br>D. Cách mạng dân tộc dân chủ nhân dân<br>"	D
"Nội dung nào không đúng với tư tưởng hồ chí minh về thái độ, phương pháp tự phê<br>bình và phê bình:<br>a. phải tiến hành thuờng xuyên như người ta rửa mặt hằng ngày.<br>b. phải thẳng thắn, chân thành, trung thực, không nể nang, không giấu giếm và cũng<br>không thêm bớt khuyết điểm.<br>c. "phải có tình đồng chí thương yêu lẫn nhau".<br>d. phải khôn khéo biến hóa cho phù hợp.<br>"	D
"Theo Hồ Chí Minh, đã có được sự thống nhất giữa lý luận và thực tiễn cần phải quán<br>triệt nguyên tắc nào?<br>A. Bệnh giáo điều<br>B. Bệnh kém lý luận, bệnh coi khinh lý luận, bệnh lý luận suông<br>C. Mù chính trị<br>D. Coi lý luận chỉ là Cái bóng của thực tiễn, không lấy lý luận làm Cốt<br>"	B
"Hồ chí minh cho rằng xây dựng con người mới phải trải qua<br>a. một quá trình lâu dài mới có được<br>b. một giai đoạn lâu dài mới thành công<br>c. một thời gian lâu dài gắn với đấu tranh gian khổ<br>"	A
"Quan điểm, Đang cần phải chăm lo giáo dục đạo đức cách mạng cho cán bộ, đào tạo<br>họ thành những người thừa kế xây dựng chủ nghĩa xã hội vừa "hồng" vừa "chuyên"<br>được nêu ra trong bài Viết nào của Bác?<br>A. Di chúc<br>B. Nâng cao đạo đức cách mạng, quét sạch Chủ nghĩa Cá nhân<br>C. Đạo đức cách mạng<br>D- Sửa đổi lối làm việc<br>"	A
"Theo Hồ Chí Minh, Đảng phải học hỏi quân chúng...<br>A. Nhưng không theo đuôi quần chúng<br>B. Tin theo quần chúng<br>C. Dựa vào quần chúng<br>D. Phục vụ quân chủng<br>"	A
"Hồ chí minh trực tiếp chỉ huy chiến dịch nào sau đây trong kháng chiến chống pháp<br>a. chiến dịch đông xuân<br>b. chiến dịch điện biên phủ<br>c. chiến dịch biên giới<br>"	C
"Tìm yếu tố không nằm trong Mặt trận Dân tộc thống nhất?<br>a. Đảng Cộng sản<br>b. Nhà nước xã hội chủ nghĩa<br>c. Các tổ chức chính trị - xã hội<br>d. Tòa án nhân dân<br>"	B
"Theo Hồ Chí Minh, cần bao nhiêu điêu kiện để đảm bảo độc lập dân tộc gắn liên với<br>chủ nghĩa xã hội?<br>A. 3 điều kiện<br>B. 4 điều kiện<br>C. 5 điều kiện<br>D. 6 điều kiện<br>"	C
"Theo hồ chí minh, đoàn kết là<br>a. truyền thống quý báu của dân tộc ta<br>b. sức mạnh vô địch của dân tộc ta<br>c. ý chí tự lực, tự cường của dân tộc ta<br>"	A
"Hồ chí minh cho rằng<br>a. văn hoá bao giờ cũng phát triển trên nền tảng xã hội<br>b. văn hoá bao giờ cũng phát triển trên nền tảng thời đại.<br>c. văn hoá bao giờ cũng phát triển trên nền tảng văn hóa.<br>"	A
"Theo hồ chí minh, cách mạng xhcn phải tiến hành đồng thời với:<br>a. cách mạng tư sản<br>b. cách mạng dân tộc dân chủ nhân dân<br>c. cách mạng văn hóa<br>"	B
"Quan điểm của hồ chí minh là:<br>a. tiến lên chủ nghĩa xã hội là bước phát triển tất yếu đối với các nước phương đông.<br>b. tiến lên chủ nghĩa xã hội là bước phát triển tất yếu của các nước đang phát triển.<br>c. tiến lên chủ nghĩa xã hội là bước phát triển tất yếu của các nước trên thế giới.<br>d. tiến lên chủ nghĩa xã hội là bước phát triển tất yếu ở việt nam sau khi nước nhà<br>giành được độc lập theo con đường cách mạng vô sản.<br>"	D
"Theo hồ chí minh, trong nhà nước vì dân, từ chủ tịch nước đến công chức bình<br>thường đều phải làm công bộc, làm đầy tớ cho nhân dân chứ không phải làm:<br>a. tướng<br>b. quan<br>c. quan cách mạng<br>d. trâu, ngựa<br>"	C
"Nguyễn ái quốc là người việt nam thứ mấy tham gia vào đảng cộng sản pháp?<br>a. thứ nhất<br>b. thứ hai<br>c. thứ ba<br>d. thứ tư<br>"	A
"Theo hồ chí minh, muốn xây dựng chủ nghĩa xã hội trước hết cần có cái gì?<br>a. khoa học - kỹ thuật tiên tiến<br>b. con người xã hội chủ nghĩa<br>c. kinh tế phát triển<br>d. tài nguyên thiên nhiên của đất nước<br>"	B
"Theo hồ chí minh, đường lối chính trị là:<br>a. một vấn đề cốt tử trong tồn tại và phát triển của đảng.<br>b. một vấn đề không quan trọng trong tồn tại và phát triển của đảng.<br>c. một vấn đề thứ yếu trong tồn tại và phát triển của đảng.<br>"	A
"Mục đích chung của mặt trận dân tộc thống nhất được hồ chí minh xác định cụ thể<br>phù hợp là:<br>a. đoàn kết chặt chẽ, lâu dài, thật sự, chân thành.<br>b. tất cả các phương án.<br>c. độc lập, tự do.<br>"	C
"Một trong những tiền đề tư tưởng, lí luận dẫn đến sự hình thành tư tưởng hồ chí minh<br>là:<br>a. giá trị truyền thống dân tộc việt nam<br>b. giá trị văn hiến dân tộc việt nam<br>c. giá trị tư tưởng dân tộc việt nam<br>d. giá trị văn minh dân tộc việt nam<br>"	A
"Hồ chí minh cho rằng đoàn kết toàn dân để<br>a. phụng sự nhân dân<br>b. phụng sự cách mạng<br>c. phụng sự tổ quốc<br>"	A
"Điểm giống nhau trong tư tưởng về xây dựng nhà nước của Hồ Chí Minh và các bậc<br>tiền nhân trong quá khứ là:<br>A. Dựa vào bạo lực vũ trang<br>B. Dựa vào dân<br>C. Dựa vào tài năng, trí tuệ, óc phán đoán<br>D. Dựa vào đạo đức cách mạng<br>E. Dựa vào tầm nhìn trí tuệ<br>"	B
"Trong tư tưởng hồ chí minh, mặt trận dân tộc thống nhất là nơi quy tụ mọi tổ chức và<br>cá nhân yêu nước người việt nam, bao gồm cả những người:<br>a. định cư ở nước ngoài<br>b. nước ngoài<br>c. tất cả các phương án<br>"	A
"Truyền thống dân tộc nào dưới đây dẫn đến hình thành tư tưởng hồ chí minh<br>a. truyền thống yêu nước, lạc quan, yêu đời; có niềm tin vào chính nghĩa, tin vào sức<br>mạnh của bản thân và dân tộc.<br>b. truyền thống lạc quan, yêu đời; có niềm tin vào chính nghĩa, tin vào sức mạnh của<br>bản thân và dân tộc.<br>c. truyền thống nhân nghĩa, thủy chung, lạc quan, yêu đời; có niềm tin vào chính<br>nghĩa, tin vào sức mạnh của bản thân và dân tộc.<br>"	A
"Theo Hồ Chí Minh, nhà nước do dân thể hiện ở chỗ<br>A. Do nhân dân quyết định<br>B. Do nhân dân chỉ phối<br>C. Do nhân dân áp đặt<br>D. Do nhân dân kiêm soát<br>"	D
"Đâu là quan điểm của hồ chí minh về chiến lược trồng người<br>a. "trồng người" là trung tâm của phát triển xã hội<br>b. "trồng người" là trung tâm phát triển của nhân loại<br>c. "trồng người" là trung tâm phát triển thế giới<br>"	A
"Hồ Chí Minh gọi đồng bào Miền nam với cái tên thân thương và trìu mến đó là<br>a. Thành đồng tổ quốc<br>b. Anh hùng bất khuất<br>c. Anh dũng kiên cường<br>d. Giai cấp cách mệnh<br>"	A
"Chọn cụm từ điền vào chỗ trống [...] đúng với tư tưởng Hồ Chí Minh: "Chính sách<br>ngoại giao của Chính phủ thì chỉ có một điều tức là thân thiện với [...] trên thế giới để<br>giữ gìn hòa bình"<br>A. Các nước xã hội chủ nghĩa<br>B. Tất cả các nước dân chủ<br>C. Các nước lớn<br>D. Mặt trận Vệt Minh<br>"	B
"Cách mạng giải phóng dân tộc muốn giành được thắng lợi cần phải:<br>a. dựa vào sự thắng lợi của cách mạng ở các nước thuộc địa khác.<br>b. dựa vào thắng lợi của cách mạng vô sản ở chính quốc.<br>c. tiến hành chủ động và sáng tạo.<br>d. tiến hành sau khi cách mạng vô sản ở chính quốc giành thắng lợi.<br>"	C
"Theo hồ chí minh, về bước đi trong thời kỳ quá độ, chúng ta phải:<br>a. trải qua nhiều bước<br>b. làm thật mau và rầm rộ<br>c. làm nhanh và rầm rộ qua nhiều bước<br>"	A
"Hồ chí minh minh cho rằng "đoàn kết phải gắn với<br>a. đấu tranh<br>b. lợi ích<br>c. tự do<br>d. dân chủ<br>"	A
"Theo Hồ Chí Minh, bọn đế quốc thực dân tuyên truyền khẩu hiệu "độc lập tự do" thực<br>chất là che đây bản chất?<br>A. "ăn cướp" và "giết người"<br>B. "ăn cắp" và "hại dân"<br>C. "bóc lột" và "đàn áp"<br>D. "cướp bóc" và "đàn áp"<br>"	C
"Khái niệm con người trong tư tưởng hồ chí minh để chỉ:<br>a. một con người cụ thể.<br>b. một cộng đồng người.<br>c. con người cụ thể gắn với hoàn cảnh lịch sử cụ thể.<br>d. tất cả các phương án.<br>"	C
"Quan điểm nào sau đây thuộc vấn đề quan hệ giữa đảng với dân theo tư tưởng hồ<br>chí minh<br>a. quan điểm dân-đồng bào<br>b. quan điểm đảng-đồng bào<br>c. quan điểm quần chúng-đồng bào<br>"	A
"Theo hồ chí minh<br>a. giải phóng dân tộc tạo tiền đề để giải phóng giai cấp<br>b. giải phóng dân tộc tạo tiền đề để giải phóng nhân loại<br>c. giải phóng dân tộc tạo tiền đề để giải phóng người lao động<br>"	A
"Theo hồ chí minh, nguyên tắc hiệp thương dân chủ đòi hỏi tất cả mọi vấn đề của mặt<br>trận đều phải được đem ra cho tất cả các thành viên cùng nhau bàn bạc công khai,<br>để đi đến nhất trí, loại trừ mọi sự áp đặt hoặc:<br>A. Dân chủ hình thức<br>B. Dân chủ tự nguyện<br>C. Chuyên quyền độc đoán<br>D. Không dân chủ<br>"	A
"Nội dung nào không đúng về giá trị lý luận và thực tiễn của tư tưởng hồ chí minh về<br>vấn đề dân tộc và cách mạng giải phóng dân tộc:<br>a. làm phong phú học thuyết mác-lênin về cách mạng thuộc địa.<br>b. soi đường thắng lợi cho cách mạng giải phóng dân tộc ở việt nam<br>c. nền tảng tư tưởng và kim chỉ nam cho hành động của cách mạng việt nam<br>D. Là tiền đề cho thắng lợi của Cách mạng tháng 8<br>"	C
"Đối với phong trào cộng sản và công nhân, quốc tế, hồ chí minh giương cao ngọn cờ<br>độc lập dân tộc gắn liền với chủ nghĩa xã hội, thực hiện đoàn kết thống nhất trên nền<br>tảng của chủ nghĩa mác-lênin và:<br>A. Chủ nghĩa yêu nước, có lý, có tình<br>B. Chủ nghĩa quốc tế vô sản, có tình, có nghĩa<br>C. Chủ nghĩa quốc tế vô sản, có lý, có tình<br>"	C
"Trong quan điểm của hồ chí minh về bản chất của nhà nước có sự thống nhất giữa<br>bản chất giai cấp công nhân với:<br>a. tính nhân dân và tính dân tộc<br>b. tính xã hội chủ nghĩa và tính dân tộc<br>c. tính nhân dân và tính xã hội chủ nghĩa<br>"	A
"Nguyên tắc quan trọng bậc nhất trong xây dựng một nền đạo đức mới theo tư tưởng<br>hồ chí minh là:<br>a. nói đi đôi với làm<br>b. nêu gương về đạo đức<br>c. xây đi đôi với chống<br>d. tu dưỡng đạo đức suốt đời<br>"	A
"Luận điểm: "Cách mệnh An Nam cũng là một bộ phận trong cách mệng thế giới. Ai<br>làm cách mệnh trong thế giới đều là đồng chí của dân An Nam cả" được trích từ tác<br>phẩm nào của Hồ Chí Minh?<br>a. Đông Dương (1923-1924)<br>b. Bản án chế dộ thực dân Pháp<br>c. Đường Cách mệnh<br>d. Tuyên ngôn Độc lập<br>"	C
"Quan điểm nào sau đây là được xem là đánh giá của hồ chí minh về giá trị của dân<br>chủ<br>a. dân chủ là của quý báu nhất của nhân dân<br>b. dân chủ là tài sản quý báu nhất của dân quyền<br>c. dân chủ là tài sản của mọi chế độ xã hội<br>"	A
"Nguyễn ÁI Quốc đọc luận cương của Lênin vào thời gian nào?<br>A. 7/1917<br>B. 7/1918<br>C. 7/1919<br>D. 7/1920<br>"	D
"Điểm đặc sắc nhất trong tư tưởng hồ chí minh về nhà nước pháp quyền là:<br>a. coi trọng luật pháp trong quản lý xã hội.<br>b. đề cao đạo đức trong quản lý xã hội.<br>c. đảm bảo tính nghiêm minh và hiệu lực của pháp luật.<br>d. kết hợp nhuần nhuyễn cả pháp luật và đạo đức trong quản lý xã hội.<br>"	D
"Luận điểm: "cách mệnh trước hết phải có cái gì? trước hết phải có đảng cách mệnh,<br>để trong thì vận động và tổ chức dân chúng, ngoài thì liên lạc với dân tộc bị áp bức và<br>vô sản giai cấp ở mọi nơi. đảng có vững thì cách mạng mới thành công, cũng như<br>người cầm lái có vững thuyền mới chạy" được trích từ tác phẩm nào của hồ chí<br>minh?<br>a. bản án chế độ thực dân pháp<br>b. đường cách mệnh<br>c. bản án chế độ thực dân pháp<br>d. thường thức chính trị<br>"	B
"hồ chí minh cho rằng<br>a. sự ra đời của cnxh trên phạm vi quốc tế là quy luật phát triển của lịch sử xã hội<br>b. sự ra đời của cnxh trên phạm vi quốc tế là quy luật phát triển của nhân loại<br>c. sự ra đời của cnxh trên phạm vi quốc tế là quy luật phát triển của lịch sử thế giới<br>"	A
"Theo hồ chí minh<br>a. giữ vững độc lập của dân tộc mình đồng thời tôn trọng độc lập của các dân tộc<br>khác<br>b. giữ vững độc lập của dân tộc mình đồng thời kính trọng độc lập của các dân tộc<br>khác<br>c. giữ vững độc lập của dân tộc mình đồng thời tôn trọng tự do của các dân tộc khác<br>d. giữ vững độc lập của dân tộc mình đồng thời giữ vững độc lập của các dân tộc<br>khác.<br>"	A
"Theo hồ chí minh, chỉ có..... mới giải phóng được các dân tộc bị áp bức và giai cấp<br>công nhân toàn thế giới.<br>a. chủ nghĩa xã hội và chủ nghĩa cộng sản.<br>b. giai cấp công nhân và giai cấp nông dân<br>c. giai cấp công nhân và nhân dân lao động<br>d. đảng cộng sản và giai cấp công nhân<br>"	A
"Khẩu hiệu "Tự do - Bình đẳng - Bác ái" ra đời ở đâu?<br>A. Đại cách mạng Pháp<br>B. Cách mạng Tân Hợi của Tôn Trung Sơn<br>C. Cải cách Minh Trị - Nhật Bản<br>D. Phong trào Duy Tên của Phan Châu Trinh<br>"	A
"Hồ chí minh cho rằng<br>a. sự ra đời của cnxh ở việt nam là sản phẩm tất yếu của quá trình phát triển lịch sử,<br>quá trình cách mạng việt nam.<br>b. sự ra đời của cnxh ở việt nam là sản phẩm tất yếu của quá trình phát triển lịch sử,<br>quá trình cách mạng thế giới<br>c. sự ra đời của cnxh ở việt nam là sản phẩm tất yếu của quá trình phát triển lịch sử,<br>quá trình cách mạng đông nam á.<br>"	A
"Đoạn viết sau đây ghi lại các điều kiện hình thành tư tưởng hồ chí minh. điều kiện nào<br>bị viết sai?<br>A. nhu cầu khách quan và bức thiết do cách mạng việt nam đặt ra là muốn cứu nước,<br>phải tìm một con đường cách mạng mới.<br>B. quê hương hồ chí minh là mảnh đất giàu truyền thống yêu nước, chống giặc ngoại<br>xâm.<br>C. hồ chí minh sinh ra trong một gia đình nhà nho yêu nước, gần gũi nhân dân, cụ<br>thân sinh có tư tưởng thương dân, chủ trương lấy dân làm hậu thuẫn cho mọi cải<br>cách chính trị.<br>D. ngay từ khi còn nhỏ ở trong trường, hồ chí minh đã nhận thức được đặc điểm thời<br>đại.<br>"	D
"Cụ Hoàng Thị Loan đã có đức tính gì ảnh hưởng tới Hồ Chí Minh?<br>A. Lòng nhân hậu và mẫn cảm<br>B. Sự yêu thương và vị tha<br>C. Tần tảo và đảm đang<br>D. Từ bi và vị tha<br>"	A
"Hồ chí minh cho rằng giải phóng dân tộc là sự nghiệp của:<br>a. toàn dân<br>b. toàn quân<br>c. toàn đảng<br>d. giai cấp công nhân<br>"	A
"Theo hồ chí minh, "ai có tài, có đức, có sức, có lòng phụng sự tổ quốc và phục vụ<br>nhân dân thì ta (....) với họ".<br>a. hợp tác<br>b. đoàn kết<br>c. bắt tay<br>d. chia sẻ<br>"	B
"Theo hồ chí minh, nhân dân lao động làm chủ nhà nước thì dẫn đến một hệ quả là<br>nhân dân có quyền:<br>a. không chịu sự kiểm soát của nhà nước<br>b. kiểm soát nhà nước<br>c. không phải đóng thuế cho nhà nước<br>d. không phải tuân theo pháp luật<br>"	B
"Theo hồ chí minh trung với nước là tuyệt đối trung thành với sự nghiệp dựng nước và<br>giữ nước, trung thành với con đường đi lên của đất nước; là suốt đời phấn đấu cho:<br>a. đảng, cho cách mạng.<br>b. nhà nước, cho cách mạng.<br>c. dân tộc, cho cách mạng.<br>"	A
"Quan điểm nào dưới đây thuộc về bản chất của cnxh trong tư tưởng hồ chí minh:<br>a. là chế độ không còn người bóc lột người<br>b. là chế độ còn một ít người bóc lột<br>c. là chế độ người bóc lột bị khinh rẻ<br>d. là chế độ người bóc lột được thừa nhận<br>"	A
"Theo hồ chí minh, giải quyết vấn đề dân tộc luôn gắn với vấn đề :<br>a. xã hội<br>b. người lao động<br>c. giai cấp<br>d. nông dân<br>"	C
"Theo hồ chí minh, nhà nước việt nam được xây dựng phải là:<br>a. nhà nước hợp pháp, hợp hiến<br>b. nhà nước quốc gia dân tộc<br>c. nhà nước tự lập, tự tôn<br>d. nhà nước bảo hộ cho phép<br>...<br>Chủ nghĩa nào sau đây ảnh hưởng đến sự hình thành tư tưởng hồ chí minh<br>a. chủ nghĩa dân tộc của grady<br>b. chủ nghĩa dân chủ của kenedy.<br>c. chủ nghĩa tam dân chủ tôn trung sơn<br>"	C
"Hồ chí minh cho rằng giai cấp địa chủ ở việt nam<br>A. Là giai Cấp phản động<br>B. Là giai cấp tiên tiến<br>C. Có thể lợi dụng<br>D. Cần phải loại bỏ<br>"	D
"Hồ chí minh cho rằng<br>A. Văn hóa là sự tổng hợp của mọi phương thức sinh hoạt cùng với biểu hiện của nó<br>mà loài người đã sản sinh ra nhằm thích ứng những nhu cầu đời sống và đòi hỏi của<br>sự sinh tồn<br>B. Văn hóa là sự tổng hợp của mọi phương thức sinh hoạt cùng với biểu hiện của nó<br>mà loài người đã sản sinh ra nhằm thích ứng những nhu cầu đời sống và đòi hỏi của<br>sự sống còn<br>C. Văn hóa là sự tổng hợp của mọi phương thức sinh hoạt cùng với biểu hiện của nó<br>mà loài người đã sản sinh ra nhằm thích ứng những nhu cầu đời sống và đòi hỏi của<br>sự trường tồn<br>"	A
"Theo hồ chí minh, mỗi cán bộ, đảng viên "đều là công bộc của dân, nghĩa là để gánh<br>việc chung cho dân, chứ không phải để:<br>a. đè đầu dân.<br>b. hạch sách dân<br>c. làm khó cho dân<br>"	A
"Lực lượng nào vừa là thành viên của mặt trận dân tộc thống nhất vừa là lực lượng<br>lãnh đạo mặt trận?<br>a. các tổ chức chính trị xã hội<br>b. đảng cộng sản việt nam<br>c. nhà nước cộng hòa xã hội chủ nghĩa việt nam<br>d. quần chúng nhân dân<br>"	B
"Trong luận điểm về cách mạng giải phóng dân tộc, chỉ ra luận điểm sai Về con<br>đường, biện pháp ;phương pháp cách mạng của Hồ Chí Minh ?<br>A. Cách mạng giải phóng dân tộc muốn thắng lợi phải cũ theo con đường cách mạng<br>vô sản<br>B. Cách mạng giải phóng dân tộc, trong điều kiện của Việt Nam, muốn thắng lợi phải<br>do Đảng cộng sản lãnh đạo<br>C. Cách mạng giải phóng dân tộc phải dựa trên lực lượng đại đoàn két dân tộc, lấy<br>liên minh làm nền tảng<br>D. Cách mạng giải phóng dân tộc cần chủ động, sáng tạo, có khả năng giành thắng<br>lợi trước sàn ở chính quốc<br>"	A
"Theo hồ chí minh, đoàn kết là điểm nào sau đây<br>a. điểm mẹ<br>b. điểm quyết định<br>c. điểm tháng lợi<br>"	A
"Quan điểm nào sau đây là nguyên tắc đoàn kết quốc tế của hồ chí minh<br>a. dựa vào sức mình là chính, ủng hộ sự giúp đỡ quốc tế, có nghĩa vụ quốc tế.<br>b. dựa vào sức mình là chính, ủng hộ sự giúp đỡ quốc tế, có nghĩa của chính mình<br>c. dựa vào sức mình là chính, ủng hộ sự giúp đỡ quốc tế, có nghĩa vụ chính quốc.<br>"	A
"Hồ chí minh cho rằng xây dựng con người mới xhcn trước hết phải<br>a. diệt trừ chủ nghĩa cá nhân<br>b. diệt trừ văn hóa phong kiến<br>c. diệt trừ văn hóa tư sản<br>"	A
"Theo hồ chí minh, trong thời kỳ quá độ còn tồn tại hình thức:<br>a. sở hữu của nhà nước và sở hữu của hợp tác xã.<br>b. sở hữu của người lao động riêng lẻ và sở hữu của nhà tư bản.<br>c. tất cả các phương án.<br>"	C
"Hồ chí minh khái quát dân chủ có nghĩa là:<br>a. dân là chủ và dân làm chủ<br>b. dân là người chủ<br>c. dân làm quản lý<br>d. dân làm người chủ<br>"	A
"Đại đoàn kết quốc tế trong tư tưởng hồ chí minh được xác định là:<br>a. một nhân tố thường xuyên và hết sức quan trọng giúp cho cách mạng việt nam đi<br>đến thắng lợi hoàn toàn.<br>b. có ý nghĩa sống còn đối với cách mạng việt nam.<br>c. vấn đề cơ bản của cách mạng việt nam.<br>d. sức mạnh giúp cho dân tộc ta vượt qua mọi thử thách, khó khăn trong dựng nước<br>và giữ nước.<br>"	A
"Các bài giảng của Nguyễn Ái Quốc tại các lớp huấn luyện cán bộ tuyên truyền của hội<br>Liên hiệp các dân tộc bị áp bức bóc lột lập hợp lại và xuất bản thành tác phẩm gì?<br>a. Bản án chế độ thực dân Pháp<br>b. Lênin và Phương Đông<br>c. Con Rồng tre<br>d. Đường Cách mệnh<br>"	D
"Đoạn viết dưới đây ghi tóm tắt lời giải thích của hồ chí minh về cần, kiệm, liêm, chính.<br>hỏi: điểm tóm tắt nào đã bị ghi nhầm nội dung?<br>a. cần là lao động cần cù, siêng năng, lao động có kế hoạch, sáng tạo và có năng<br>suất lao động cao...<br>b. kiệm là không xa xỉ, không hoang phí, không bừa bãi...<br>c. liêm là luôn tôn trọng của công và của dân, không tham tiền của, địa vị, danh tiếng.<br>d. chính là trong sạch, không tham lam đồng xu, hạt thóc của nhà nước, của dân.<br>"	D
"trong tư tưởng hồ chí minh, nền tảng của khối đại đoàn kết dân tộc là:<br>a. liên minh công-nông<br>b. liên minh công-nông, lao động trí óc.<br>c. liên minh công-nông và các tầng lớp lao động khác.<br>d. liên minh công-nông và các lực lượng yêu nước khác.<br>"	C
"Theo hồ chí minh, ưu điểm lớn nhất của chủ nghĩa tam dân của tôn trung sơn là gì?<br>a. chống phong kiến.<br>b. đấu tranh vì tự do, dân chủ.<br>c. phù hợp với điều kiện thực tế nước ta.<br>"	C
"Đâu là chức năng của văn hóa theo tư tưởng hồ chí minh?<br>a. bồi dưỡng những phẩm chất, phong cách và lối sống tốt đẹp, lành mạnh; hướng<br>con người đến chân, thiện, mỹ để hoàn thiện xã hội.<br>b. bồi dưỡng những phẩm chất, phong cách và lối sống tốt đẹp, lành mạnh; hướng<br>con người đến chân, thiện, mỹ để hoàn thiện bản thân.<br>c. bồi dưỡng những phẩm chất, phong cách và lối sống tốt đẹp, lành mạnh; hướng<br>con người đến chân, thiện, mỹ để hoàn thiện con người.<br>"	C
"Nội dung nào không phải là thực chất vấn đề dân tộc thuộc địa trong tư tưởng hồ chí<br>minh:<br>a. đấu tranh chống chủ nghĩa thực dân, giải phóng dân tộc.<br>b. lựa chọn con đường phát triển của dân tộc là cnxh.<br>c. đòi quyền tự do dân chủ tối thiểu cho nhân dân.<br>"	C
"Đâu không phải là nguyên tắc xây dựng chủ nghĩa xã hội trong thời kỳ quá độ theo tư<br>tưởng hồ chí minh?<br>A. Mọi tư tưởng hành động phải tuân thủ tuyệt đối theo chủ nghĩa Mác - Lênin<br>B. Phải giữ vững được độc lập dân tộc<br>C. Phải đoàn kết, học tập kinh nghiệm từ thực tiễn<br>D. Xây đi đôi với chống<br>"	A
"Theo hồ chí minh, muốn tăng cường đoàn kết quốc tế trong cuộc đấu tranh vì mục<br>tiêu chung, các đảng cộng sản phải tiến hành có hiệu quả việc giáo dục chủ nghĩa<br>yêu nước chân chính kết hợp với:<br>a. chủ nghĩa vô sản.<br>b. chủ nghĩa xã hội.<br>c. chủ nghĩa quốc tế.<br>d. chủ nghĩa mác - lênin.<br>"	A
"theo hồ chí minh, trong quá trình hoạt động, đảng ta phải chủ ý học tập, kế thừa<br>những kinh nghiệm tốt của các đảng cộng sản khác, đồng thời đảng ta phải tổng kết<br>kinh nghiệm của mình để:<br>a. bổ sung lý luận về đảng cộng sản cầm quyền<br>b. bổ sung tư duy của đảng cộng sản<br>c. bổ sung đường lối của đảng cộng sản<br>d. bổ sung chủ nghĩa mác - lênin.<br>"	A
"Tính chất nhân văn trong bạo lực cách mạng của hồ chí minh là<br>a. con đường cách mạng bạo lực gắn bó hữu cơ với nhân văn, hòa bình<br>b. con đường cách mạng bạo lực gắn bó hữu cơ với nhân đạo, hòa bình<br>c. con đường cách mạng bạo lực gắn bó hữu cơ với tự do, hòa bình<br>"	B
"Trong các luận điểm sau, luận điểm nào là của Hồ Chí Minh:<br>a. Vô sản tất cả các nước, đoàn kết lại<br>b. Vô sản tất cả các nước và các dân tộc bị áp bức đoàn kết lại<br>c. Vô sản tất cả các nước liên hiệp lại<br>d. Lao động tất cả các nước, đoàn kết lại<br>"	D
"Theo hồ chí minh, văn hóa là đời sống tinh thần của xã hội, thuộc:<br>a. kiến trúc thượng tầng<br>b. cơ sở hạ tầng<br>c. tất cả các phương án<br>d. Lực lượng sản xuất<br>"	A
"Hồ Chí Minh cho rằng, nhà nước của dân, do dân và vì dân phải:<br>A. Do đảng Cộng sản lãnh đạo và nhân dân làm chủ<br>B. Do nhân dân quản lý và nhân dân làm chủ<br>C. Do giai cấp công nhân lãnh đạo và nhân dân làm chủ<br>"	A
"Pháp quyền nhân nghĩa được hiểu là?<br>A. Nhà nước phải tôn trọng, đảm bảo thực hiện đầy đủ quyền con người, chăm lo đến<br>lợi ích của con người<br>B. Nhà nước phải tôn trọng những quyền tự do cá nhân, vì lợi ích của con người<br>C. Nhà nước phải đảm báo tỉnh nhân văn trong pháp luật, quan tâm đến lợi ích mỗi<br>người<br>D. Nhà nước phải tôn trọng những quyền tự do cá nhân vì mục đích nhân văn cao cả<br>"	A
"Điều kiện thực hiện khối đại đoàn kết tư tưởng Hồ Chi Minh Về khối đại đoàn kết dân<br>tộc?<br>A. Truyền thống yêu thiên nhiên<br>B. Truyền thống yêu con người<br>C. Truyền thống yêu nước, nhân ái, tinh thần cố kết cộng đồng<br>"	C
"Tư tưởng Hồ Chí Minh Về cách mạng Việt Nam được xem là:<br>A. Hệ thống các quan điểm cụ thể Về cách mạng Việt Nam<br>B. Một nhóm các quan điểm cụ thể Về cách mạng Việt Nam<br>C. Một hệ thống các học thuyết Về cách mạng Việt Nam<br>"	A
"Theo hồ chí minh, nội dung nào không đúng để phát huy động lực con người:<br>a. phát huy sức mạnh đoàn kết của cả cộng đồng dân tộc.<br>b. phát huy sức mạnh của cá nhân con người.<br>c. phát huy các yếu tố chính trị, tinh thần.<br>d. Bài học xương máu của cách mạng Việt Nam<br>"	C
"Nguồn gốc nào sau đây quyết định tư tưởng hồ chí minh:<br>a. tư tưởng tam dân của tôn trung sơn<br>b. tư tưởng của khổng tử<br>c. tư tưởng của chủ nghĩa mác-lênin<br>d. tư tưởng của giêsu<br>"	C
"Nguyên tắc tối cao để đoàn kết rộng rãi trong quần chúng nhân dân là:<br>a. yêu dân, tin dân, dựa vào dân, vì hạnh phúc của nhân dân<br>b. đoàn kết trên cơ sở độc lập tự chủ<br>c. đoàn kết chặt chẽ, chân thành<br>d. đoàn kết trên cơ sở tự nguyện<br>"	A
"Hồ chí minh lưu ý<br>a. đảng cầm quyền, đảng lãnh đạo để cho dân làm chủ<br>b. đảng cầm quyền, đảng lãnh đạo để cho dân quản lý<br>c. đảng cầm quyền, đảng lãnh đạo để cho dân giám sát<br>"	A
"Điểm khác nhau trong tư tưởng Về xây dựng nhà nước của Hồ Chí Minh và các bậc<br>tiền nhân?<br>A. Con đường cứu nước<br>B. Phương pháp cứu nước<br>C. Tinh thần yêu nước<br>D. Tất cả phương án trên<br>"	D
"Hồ chí minh vạch ra mục tiêu của cách mạng giải phóng dân tộc thuộc địa là:<br>a. đánh đổ ách thống trị của chủ nghĩa thực dân, giành độc lập dân tộc và thiết lập<br>chính quyền của nhân dân.<br>b. đánh đổ ách thống trị của chủ nghĩa thực dân, giành độc lập dân tộc và thiết lập<br>chính quyền về tay người lao động.<br>c. đánh đổ ách thống trị của chủ nghĩa thực dân, giành độc lập dân tộc và thiết lập<br>chính quyền về tay lực lượng cách mạng.<br>d. đánh đổ ách thống trị của chủ nghĩa thực dân, giành độc lập dân tộc và thiết lập<br>chính quyền của công nông.<br>"	A
"Điền vào chỗ trống. "Đại đoàn kết dân tộc là....của cách mạng".<br>A. Mục tiêu, nhiệm vụ<br>B. Chìa khóa, con đường<br>C. Chìa khóa<br>D. Biện pháp, phương hướng<br>"	C
"Theo Hồ Chí Minh, lực lượng của cách mạng giải phóng dân tộc là:<br>A. Toàn dân tộc<br>B. Công nhân và nông dân<br>C. Trí thức, tiểu tư sản, tư sản dân tộc, địa chủ vừa và nhỏ<br>"	A
"Quan điểm nào dưới đây thuộc về bản chất của cnxh trong tư tưởng hồ chí minh?<br>a. chế độ chính trị do nhân dân làm chủ.<br>b. chế độ chính trị do nhân dân sáng tạo.<br>c. chế độ chính trị do nhà nước làm chủ.<br>d. chế độ chính trị do đảng làm chủ.<br>"	A
"Trong xã hội hiện nay, vận dụng tư tưởng Hồ Chí Minh Về đạo đức cán bộ có còn phù<br>hợp không?<br>A. Có. Vì tư tưởng của Người vẫn mang tính thời sự<br>B. Không. Vì tư tưởng của Người đã không còn phù hợp<br>C. Có. Vi tư tưởng của Người luôn mang tính thời sự vì vậy phải áp dụng phù hợp với<br>tung<br>nước<br>D. Không. Vì cán bộ hiện nay đều đã được rèn luyện đạo đức cách mạng trước khi<br>thực hiện ..là thấm nhuần chủ nghĩa Mác — Lênin<br>"	C
"Nguyễn tất thành lấy tên là nguyễn ái quốc vào thời gian nào?<br>a. khi bác lên tàu từ bến nhà rồng năm 1911.<br>b. khi bác tham gia sáng lập đảng cộng sản pháp tại đại hội tua 12/1920.<br>c. tại hội nghị vécxay (pháp) ngày 18/6/1919.<br>d. khi bác sang liên xô làm việc ở ban phương đông của quốc tế cộng sản tháng<br>6/1923.<br>"	C
"Hồ Chí Minh cho rằng quá độ lên chủ nghĩa xã hội ở Việt Nam phải tiến hành?<br>A. Từ từ, từng bước một<br>B. Nhanh chóng, chính xác<br>C. Cẩn thận, không chủ quan<br>"	A
"Để chuẩn bị thành lập Đảng Cộng sản Việt Nam, Nguyễn Ái Quốc đã từ Liên Xô Về<br>Trung Quốc năm nào?<br>a. 1925<br>b. 1927<br>c. 1923<br>d. 1924<br>"	D
"khái niệm con người trong tư tưởng hồ chí minh để chỉ:<br>a. một con người cụ thể.<br>b. một cộng đồng người.<br>c. con người cụ thể gắn với hoàn cảnh lịch sử cụ thể.<br>d. tất cả các phương án.<br>"	C
"Trong mặt trận dân tộc thống nhất, đảng cộng sản là:<br>a. thành viên của mặt trận dân tộc thống nhất.<br>b. lực lượng lãnh đạo mặt trận dân tộc thống nhất.<br>c. vừa là thành viên, vừa là lực lượng lãnh đạo mặt trận dân tộc thống nhất.<br>d. đại biểu của giai cấp công nhân trong mặt trận dân tộc thống nhất.<br>"	C
"Nguyễn Sinh Cung theo cha lần đầu tiên đến Huế vào thời gian nào?<br>A. Từ năm 1895 đến năm 1901<br>B. Từ năm 1896 đến năm 1906<br>C. Từ năm 1896 đến năm 1901<br>D. Từ năm 1895 đến năm 1905<br>...<br>Theo hồ chí minh, để lãnh đạo mặt trận, đảng phải đi đúng đường lối quần chúng,<br>không được:<br>a. vận động, giáo dục, thuyết phục, nêu gương, lấy lòng chân thành để đối xử, cảm<br>hóa, khơi gợi tinh thần tự giác, tự nguyện.<br>b. quan liêu, mệnh lệnh và gò ép.<br>c. lấy quyền uy để thuyết phục mọi người đi theo.<br>"	B
"Theo hồ chí minh, đạo đức mới chỉ có thể được xây dựng trên cơ sở sự tự giác tu<br>dưỡng đạo đức của mỗi người thông qua hoạt động thực tiễn, phải kiên trì rèn luyện<br>như:<br>a. công việc rửa mặt hàng ngày.<br>b. việc đánh răng hàng ngày.<br>c. việc ăn uống hàng ngày<br>d. việc hít thở hàng ngày<br>"	A
"Hồ chí minh cho rằng<br>a. trong giai đoạn thuộc địa, giải phóng chính trị - xã hội là trước hết, mở đường để<br>giải phóng văn hóa<br>b. trong giai đoạn thuộc địa, giải phóng chính trị - xã hội là trước hết, mở đường để<br>giải phóng nhân loại.<br>c. trong giai đoạn thuộc địa, giải phóng chính trị - xã hội là trước hết, mở đường để<br>giải phóng dân tộc.<br>"	A
"Giai đoạn nào sau đây hình thành cơ bản tư tưởng hồ chí minh trong việc tìm thấy<br>con đường cứu nước, giải phóng dân tộc<br>a. 1911 đến 1930<br>b. 1911 đến 1920<br>c. 1911 đến 1935<br>"	B
"Một trong những yêu cầu cơ bản trong nghiên cứu tư tưởng hồ chí minh là:<br>A. Đảm bảo thống nhất giữ nguyên tắc tính đảng và tính khoa học<br>B. Đảm bảo thống nhất tỉnh thực chứng và duy lý<br>C. Đảm bảo thống nhất giữa khoa học và thực tiễn<br>"	A
"Lực lượng đoàn kết quốc tế theo hồ chí minh cần phải đoàn kết với<br>a. giai cấp công nhân, lực lượng xhcn, phong trào cộng sản và công nhân quốc tế,với<br>các dân tộc thuộc địa bị áp bức và các lực lượng tiến bộ trên thế giới.<br>b. giai cấp nông dân, lực lượng xhcn, phong trào cộng sản và công nhân quốc tế,với<br>các dân tộc thuộc địa bị áp bức và các lực lượng tiến bộ trên thế giới.<br>c. giai cấp lao động, lực lượng xhcn, phong trào cộng sản và công nhân quốc tế,với<br>các dân tộc thuộc địa bị áp bức và các lực lượng tiến bộ trên thế giới.<br>"	A
"Hồ chính minh cho rằng cứ viết lên trán hai chữ cộng sản là<br>a. dân yêu dân mến<br>b. dân khâm phục<br>c. dân tin<br>"	A
"Trong các mệnh đề Về đạo đức của mình, theo Hồ Chí Minh, đâu là cái đức lớn nhất :<br>A. Trung với nước, hiếu với dân<br>B. Tận tụy quên mình<br>C. Cần, kiêm, liêm, liêm, chính, chí công vô tư<br>D. Khiêm tốn, giản dị<br>"	C
"Hồ chí minh nhắc cán bộ nhà nước phải biết<br>a. làm lợi cho dân<br>b. lao động vì dân<br>c. phấn đấu vì dân<br>"	A
"Con đường cứu nước của hồ chí minh là:<br>a. độc lập dân tộc gắn liền với chủ nghĩa xã hội.<br>b. giải phóng dân tộc gắn liền với chủ nghĩa xã hội.<br>c. giải phóng dân tộc gắn với chủ nghĩa dân tộc.<br>d. độc lập dân tộc gắn liền với chế độ dân chủ.<br>"	A
"Trong tư tưởng hồ chí minh, nhân dân được xác định vị trí như thế nào của cách<br>mạng?<br>a. là mục tiêu của cách mạng<br>b. là động lực của cách mạng<br>c. vừa là mục tiêu vừa là động lực của cách mạng<br>d. là người bạn đường của cách mạng<br>"	C
"Hồ chí minh cho rằng<br>a. văn hóa ngang hàng với các lĩnh vực khác, có mối quan hệ với các lĩnh vực khác<br>b. văn hóa không như lĩnh vực khác, có mối quan hệ với các lĩnh vực khác<br>c. văn hóa là mọi lĩnh vực có mối quan hệ ngang hàng<br>"	A
"Theo Hồ Chí Minh, nhân dân lao động làm chủ Nhà nước thì dẫn đến một hệ quả là<br>nhân dân.<br>A. Được biết tất cả công việc của nhà nước<br>B. Kiểm soát Nhà nước<br>C. Được tham văn những sự kiện quan trọng trong đất nước<br>D. Được bãi miễn chính phủ trong nước<br>"	B
"Nguyên tắc cơ bản nào sau đây cần phải quán triệt trong nghiên cứu tư tưởng hồ chí<br>minh?<br>a. quan điểm kế thừa và phát triển<br>b. quan điểm kế thừa và toàn diện<br>c. quan điểm cách mạng và cụ thể<br>d. quan điểm toàn diện và cụ thể<br>"	A
"Vận dụng tư tưởng hồ chí minh cần phải nắm vững nguyên tắc:<br>a. quan điểm lịch sử thế giới<br>b. quan điểm lịch sử việt nam<br>c. quan điểm lịch sử cụ thể<br>d. quan điểm lịch sử toàn diện<br>"	C
"Theo hồ chí minh, cách mạng giải phóng dân tộc cần tiến hành bằng:<br>a. con đường cách mạng bất bạo động<br>b. con đường cách mạng bạo lực<br>c. con đường cách mạng ôn hòa<br>d. con đường cách mạng cải lương<br>"	B
"Trong xây dựng chủ nghĩa xã hội, hồ chí minh chủ trương đối xử với giai cấp tư sản<br>dân tộc như thế nào?<br>a. xóa bỏ quyền sở hữu về tư liệu sản xuất của họ<br>b. không xóa bỏ quyền sở hữu tư liệu sản xuất của họ<br>c. đánh đổ họ với tư cách là giai cấp bóc lột<br>d. phát triển giai cấp này cả về số lượng và chất lượng<br>"	C
"Theo hồ chí minh, nhà nước vì dân là:<br>a. do nhân dân lập nên<br>b. quyền lực của nhà nước và xã hội thuộc về nhân dân<br>c. tất cả các phương án<br>d. nhà nước lấy lợi ích chính đáng của nhân dân làm mục tiêu<br>"	C
"Đâu là nguyên tắc đoàn kết quốc tế trong tư tưởng hồ chí minh<br>a. đảm bảo mục tiêu độc lập của dân tộc mình và mục tiêu đại chúng.<br>b. đảm bảo mục tiêu độc lập của dân tộc mình và mục tiêu của nhân loại<br>c. đảm bảo mục tiêu độc lập của dân tộc mình và mục tiêu thời đại.<br>"	C
"Trong Di Chúc Hồ Chí Minh viết rằng:<br>A. Đảng phải có kế hoạch tốt để phát triển kinh tế, văn hóa<br>B. Đảng phải có kế hoạch tốt để phát triển kinh tế, chính trị<br>C. Đảng phải có kế hoạch tốt để phát triển kinh tế, xã hội<br>"	A
